#########################
#kccccccccccbcccccccccck#
#c#####################c#
#c#scccccccccccccccccs#c#
#c#c########c########c#c#
#ccccccccccccccccccccccc#
#c##########c##########c#
#kccccccccb#p#bcccccccck#
#c##########c##########c#
#ccccccccccccccccccccccc#
#c#c########c########c#c#
#c#vcccccccccccccccccv#c#
#c#####################c#
#kccccccccccbcccccccccck#
#########################